====Note Bản đồ: Note ra các cột mốc, số nhà, chú ý bên trái/phải
 + Địa điểm mới: Coi map dưới 2 dạng sơ đồ + ảnh chụp. > Mường tượng
 
==== Vệ sinh: 
1. Mặt: Râu, Mũi, Mắt
2. Da: Tắm, Khử mùi....
3. Nội thể: đánh răng
4. Nội thể: tiểu tiện,...
4. Quần áo: Chọn quần áo khác ko nhăn ko dơ/mùi?

==== Đồ dùng
  1. Mắt: Mắt kính
  2. Miệng: Khẩu trang
  3. Tay trái: Đồng hồ/ tràng hạt
  4. Đùi trái: Điện thoại (2 cái), Đồ sạc
  5. Đùi phải: Ví + tiền lẻ

==== Bọc Giáy tờ 
1. Bọc Nhà nước: Trong bọc: CCCD + Giấy phép lái xe + Bảo hiểm xe máy (09/2025 hết hạn)
2. Bọc công việc: Thẻ nhân viên (chưa nhận), Thẻ gửi xe, Chía khóa tủ nhân viên
3. Bọc văn phòng: Giấy/Sổ + viêt
4. Các giấy tờ khác: Thẻ mua sắm - Thẻ siêu thị, photo CCCD công chứng etc
5. Sách?

==== Y tế
1. Nước uống
2. Đồ ăn (bánh mì) ?, Trái cây, Ăn vặt
3. Nhỏ mắt
4. Bọc y tế: Dầu gió xanh, Móc tai, Hít mũi, Khăn giấy
5. Đồ thay khi đi xe đạp

==== Nhà cửa
1. Gác: Đóng cửa sổ, Kéo cầu dao, xịt muỗi
2. Nhà dưới: Khóa cửa-chìa khóa, tắt điện
3. Xe: Bánh xe, Xăng, Nón
4. Trường hợp khẩn cấp: Áo mưa, Dù?
	Mở sẵn google map điện thoại.